100000000000
100000000000
111111000000
100000000000
100011111000
100000000000
100000000000
111111111111