1000000000001000000000001
1000000000011100000000001
1000000000000000000000001
1000000000111110000000001
1000000000000000000000001
1000000011111111100000001
1000000000001000000000001
1011110000000000000111101
1000000000001000000000001
1000111110000000111110001
1000000000000000000000001
1000000000001000000000001
1111111111111111111111111